###################
#........#........#
#*##.###.#.###.##*#
#.................#
#.##.#.#####.#.##.#
#....#...#...#....#
####.### # ###.####
   #.#       #.#
####.# ## ## #.####
.....  #   #  .....
####.# ##### #.####
   #.#       #.#
####.# ##### #.####
#........#........#
#.##.###.#.###.##.#
#*.#..... .....#.*#
##.#.#.#####.#.#.##
#....#...#...#....#
#.######.#.######.#
#.................#
###################
